....█........╔══════╗...
....║........║......║...
.╔══╬════╗..╔╬══╗...║...
.║..║....║..║║..║...║...
.║..╚══╗.╚══╩╝..╚═╦═╝...
.╚════╩═════════════════