.....╔══════╗......═....
════╗║......║......█....
.╔══╬╝..╔═══╣...╗..║....
.║..║...║...╚═╦═╝╚╦╝....
.╚╦═╩═══╣.....║...║.....
..╚══...║.....╚═══╝.....