.....╔══════╗......═....
.═══╗║......║......█....
.╔══╬╝..╔═══╣...╗..║....
.║..║...║...╚═╦═╝╚╦╝....
.╚╦═╩═══╣.....║...║.....
..╚══...║.....╚═══╝.....