█....╔════╗.............
║....║....║.............
╠════╬╗..╔╣..╔══════╗...
║....║║..║║..║......║...
╚══╗.╚╩══╩╝..╚══╦═══╝...
═══╬════════════╝.....══